Pocket Casts ist die weltweit leistungsstärkste Plattform für Podcasts – gemacht von Hörern für Hörer. Unser Podcast Player bietet ausgefeilte Tools, mit denen du Podcasts hören, suchen und neue entdecken kannst. Finde deine nächsten Favoriten mit unseren Podcast-Empfehlungen, die speziell für dich zusammengestellt wurden. Genieße deine Lieblingspodcasts ganz einfach ohne Abonnement.

Die Presse ist begeistert:
• Wired: „Pocket Casts ist die Podcast-App, die jeder iPhone-Benutzer braucht.“
• iMore: „Pocket Casts ist die beste Podcast-App für das iPhone.“

Pocket Casts verfügt über einfache, leistungsstarke Funktionen und eine unbegrenzte Podcast-Datenbank – hier wird jeder zum Podcast-Fan.

WIR SIND VERSESSEN AUF DETAILS
• Design: Podcasts einfach anhören, verwalten und finden.
• Themes: Dunkles Design? Helles Design? Bei uns wird jeder fündig. Mit unserem extradunklen Theme kommen selbst OLED-Freunde auf ihre Kosten.
• Universell: Individuelle, aber vertraute iPad-Benutzeroberfläche mit Unterstützung von Slide Over, geteiltem Bildschirm und Bild in Bild.
• Überall zuhause: Über CarPlay, AirPlay, Chromecast und Sonos. hörst du deine Podcasts an mehr Orten als je zuvor.

STARKE WIEDERGABEFUNKTIONEN
• Bald verfügbar: Erstelle automatisch eine Wiedergabewarteschlange aus deinen Lieblingssendungen. Melde dich an und lasse deine Warteschlange mit all deinen Geräten synchronisieren.
• Weniger Pausen: Kürze deine Folgen, indem du stumme Passagen ausschneidest.
• Variable Geschwindigkeit: Du hast die Wahl zwischen 0,5- bis 3-facher Wiedergabegeschwindigkeit.
• Lautstärke-Booster: Erhöhe die Lautstärke der Stimmen und verringere gleichzeitig Hintergrundgeräusche.
• Streamen: Spiele Folgen auch von unterwegs ab.
• Kapitel: Wechsle leicht zwischen verschiedenen Kapiteln und bewundere die eingebetteten Kunstwerke, die vom Autor hinzugefügt wurden. Wir unterstützen die Kapitelformate MP3 und M4A.
• Audio & Video: Beim Abspielen deiner Lieblingsfolgen kannst du zwischen Audio und Video wechseln.
• Wiedergabe überspringen: Überspringe die Einführung oder bewege dich in anpassbaren Intervallen innerhalb von Folgen vor und zurück.
• Apple Watch: Steuere die Wiedergabe über deine Apple Watch-App. Ändere die Lautstärke oder Effekte, ohne dein Telefon zu berühren.
• Schlummerfunktion: Wir pausieren deinen Podcast, damit du deinen wohlverdienten Schlaf bekommst.
• Airplay & Chromecast: Spiele Folgen mit einem einzigen Tippen auf deinem Fernseher oder über deine Lautsprecher ab.
• Sonos: Durchsuche deine Podcasts und gib sie direkt über die Sonos-App wieder.
• CarPlay: Wenn du ins Auto steigst, sind wir dabei.

INTELLIGENTE TOOLS
• Synchronisation: Abonnements, Up Next, dein Hörverlauf, Wiedergaben und Filter – alles ist sicher in der Cloud gespeichert. Mach einfach da weiter, wo du aufgehört hast – auf einem anderen Gerät oder sogar im Web.
• Aktualisierung: Unsere Server suchen stets nach neuen Folgen, damit du dich um anderes kümmern kannst.
• Benachrichtigungen: Wenn du möchtest, informieren wir dich, sobald neue Folgen verfügbar sind.
• Automatischer Download: Lade automatisch Folgen herunter, um sie offline abzuspielen.
• Filter: Organisiere deine Episoden über individuelle Filter.
• Speicher: Alle Tools, die du brauchst, damit du in deiner Podcast-Sammlung den Überblick behältst.

ALLE DEINE FAVORITEN
• Neues entdecken: Abonniere Podcasts in iTunes und mehr. Suche in Charts, Netzwerken und Kategorien.
• Teilen: Teile Podcasts und einzelne Folgen mit der Welt.
• OPML: Dank OPML-Import bist du sofort bereit einzusteigen. Exportiere deine Podcasts zu jedem beliebigen Zeitpunkt.

Das sind nur einige der leistungsstarken, praktischen Funktionen, die Pocket Casts zu deiner perfekten Podcast-App machen. Worauf wartest du also noch?

Auf pocketcasts.com findest du weitere Informationen über die Webversion und weitere Plattformen, die Pocket Casts unterstützt.
