Pocket Casts — одна из самых мощных в мире платформ для подкастов, приложение, созданное слушателями для слушателей. Наш плеер подкастов располагает самыми обширными возможностями поиска и прослушивания подкастов. Вы больше никогда не пропустите ничего важного с нашими полезными рекомендациями по поиску и прослушиванию любимых подкастов — вам даже не придётся оформлять подписку!

Вот, что пишут о нас в прессе:
• Wired: «Pocket Casts — это приложение для подкастов, необходимое каждому пользователю iPhone».
• iMore: «Pocket Casts — лучшее приложение для подкастов для iPhone».

Вы обязательно найдёте именно то, что нравится лично вам, благодаря уникальному набору простых, но эффективных функций и неограниченной базе данных подкастов.

МЫ ТОПИМ ЗА ТОЧНОСТЬ
• Оформление: удобство прослушивания, поиска и настройки подкастов.
• Темы: вы на тёмной или светлой стороне? Какой бы режим вы ни предпочли, у нас есть всё. Даже тема Extra Dark для любителей светодиодов.
• Универсальные функции: хорошо известный, настраиваемый интерфейс iPad, поддерживающий режимы Slide Over, Split View и Picture in Picture.
• Без ограничений: CarPlay, AirPlay, Chromecast и Sonos. Вы сможете слушать подкасты практически везде.

ЭФФЕКТИВНЫЕ ФУНКЦИИ ВОСПРОИЗВЕДЕНИЯ
• В очереди: автоматическое создание очереди воспроизведения любимых эпизодов. Выполните вход, и функция «В очереди» синхронизирует список воспроизведения на ваших устройствах.
• Обрезка пустот: вырезайте из подкастов моменты без речи и экономьте часы прослушивания.
• Настройка скорости: меняйте скорость воспроизведения от 0,5 до 3x.
• Выборочное усиление громкости: увеличьте громкость голосов, снизив уровень шумов.
• Потоковая передача: прослушивайте выпуски на лету.
• Главы: легко переходите между главами и получайте удовольствие от авторского оформления (поддерживаются форматы глав MP3 и M4A).
• Аудио и видео: вы можете проигрывать любимые выпуски, переключаясь между режимами аудио и видео.
• Пропуск воспроизведения: пропускайте вступительные части выпусков и перескакивайте между выпусками, используя настраиваемые интервалы пропуска.
• Apple Watch: вы сможете управлять воспроизведением из приложения Apple Watch, настраивать громкость и изменять звуковые эффекты, не прикасаясь к смартфону.
• Таймер спящего режима: выпуски будут приостанавливаться, чтобы вы могли поспать.
• Airplay и Chromecast: воспроизводите выпуски на ТВ или в динамиках одним нажатием.
• Sonos: просматривайте и воспроизводите коллекции подкастов в приложении Sonos.
• CarPlay: прослушивайте подкасты в машине.

УМНЫЕ ИНСТРУМЕНТЫ
• Синхронизация: подписки, в очереди, история прослушиваний, воспроизведение и фильтры — все эти функции надёжно хранятся в облаке. Вы всегда можете продолжить прослушивание на другом устройстве или в браузере.
• Обновление: наши серверы проверят наличие новых выпусков, чтобы вы ничего не пропустили.
• Уведомления: как только появятся новые выпуски, мы вам сообщим.
• Автоматическая загрузка: автозагрузка выпусков для проигрывания в автономном режиме.
• Фильтры: с помощью настраиваемых фильтров вы сможете навести порядок в коллекции.
• Хранилище: все инструменты, необходимые для управления подкастами.

ИЗБРАННОЕ
• Поиск: подписка на любые подкасты в iTunes и других службах. Поиск по чартам, сетям и рубрикам.
• Публикация: расскажите всему свету и отправьте песню эту.
• Формат OPML: импортируйте OPML без труда. Экспорт коллекции в любое время.

Pocket Casts — это шедевр в мире подкастов, который поразит вас. Чего вы ждете?

Переходите на сайт pocketcasts.com и найдите там информацию о веб-версии и других платформах, поддерживаемых Pocket Casts.
